Signals	Package
eststo	estout
estadd	estout
estpost	estout
esttab	estout
fegen	ftools
fcollapse	ftools
fmerge	ftools
fisid	ftools
flevelsof	ftools
fsort	ftools
gcollapse	gtools
greshape	gtools
gegen	gtools
gcontract	gtools
gisid	gtools
gisin	gtools
glevelsof	gtools
gduplicates	gtools
gquantiles	gtools
